11 11
1 1
###########
#       D #
# #### # ##
# #    #  #
# # #  #  #
##  # ### #
# ## ##E#D#
##D     # #
#   ##### #
###D      #
###########