10 9
1 1
##########
# #L D  L#
# # #### #
# # #EL# #
# #D## DY#
# #L  L# #
# ###### #
#LD     L#
##########